19 20
####################
#                  #
#                  #
#                  #
#       D          #
#       D          #
#       D   L      #
#       D          #
#    S  D          #
#       D          #
#    S             #
#                  #
#                  #
#                  #
#           E      #
#KKKK              #
#KKKK              #
#KKKK              #
####################
