10 11
##########
#        #
#     A  #
#     A  #
#     A  #
#   D A  #
#   K Q L#
#    S E #
#        #
##########
