10 11
##########
#        #
#   P    #
#        #
#   A    #
#   D    #
#   K    #
#        #
#        #
##########
